_->damage.death,damage.fallbig,damage.fallsmall,damage.hit,liquid.splash,liquid.swim

BAT->mob.bat.death,,,mob.bat.hurt,,

BLAZE->mob.blaze.death,damage.fallbig,damage.fallsmall,mob.blaze.hit,liquid.splash,liquid.swim

CAVE_SPIDER->mob.spider.death,damage.fallbig,damage.fallsmall,mob.spider.say,liquid.splash,liquid.swim

CHICKEN->mob.chicken.hurt,,,mob.chicken.hurt,liquid.splash,liquid.swim

COW->mob.cow.hurt,damage.fallbig,damage.fallsmall,mob.cow.hurt,liquid.splash,liquid.swim

CREEPER->mob.creeper.death,damage.fallbig,damage.fallsmall,mob.creeper.say,liquid.splash,liquid.swim

ENDER_DRAGON->mob.enderdragon.end,,,mob.enderdragon.hit,,

ENDERMAN->mob.endermen.death,damage.fallbig,damage.fallsmall,mob.endermen.hit,liquid.splash,liquid.swim

GHAST->mob.ghast.death,,,mob.ghast.scream,,

GIANT->damage.hit,damage.fallbig,damage.fallsmall,damage.hit,liquid.splash,liquid.swim

HORSE->damage.fallbig,damage.fallsmall,liquid.splash,liquid.swim,mob.horse.death,mob.horse.donkey.death,mob.horse.zombie.death,mob.horse.skeleton.death,mob.horse.hit,mob.horse.donkey.hit,mob.horse.zombie.hit,mob.horse.skeleton.hit

IRON_GOLEM->mob.irongolem.death,damage.fallbig,damage.fallsmall,mob.irongolem.hit,liquid.splash,liquid.swim

MAGMA_CUBE->damage.fallbig,damage.fallsmall,liquid.splash,liquid.swim,mob.slime.big,mob.slime.small,mob.slime.big,mob.slime.small

MUSHROOM_COW->mob.cow.hurt,damage.fallbig,damage.fallsmall,mob.cow.hurt,liquid.splash,liquid.swim

OCELOT->mob.cat.hitt,damage.fallbig,damage.fallsmall,mob.cat.hitt,liquid.splash,liquid.swim

PIG->mob.pig.death,damage.fallbig,damage.fallsmall,mob.pig.say,liquid.splash,liquid.swim

PIG_ZOMBIE->mob.zombiepig.zpigdeath,damage.fallbig,damage.fallsmall,mob.zombiepig.zpighurt,liquid.splash,liquid.swim

SHEEP->mob.sheep.say,damage.fallbig,damage.fallsmall,mob.sheep.say,liquid.splash,liquid.swim

SILVERFISH->mob.silverfish.kill,damage.fallbig,damage.fallsmall,mob.silverfish.hit,liquid.splash,liquid.swim

SKELETON->mob.skeleton.death,damage.fallbig,damage.fallsmall,mob.skeleton.hurt,liquid.splash,liquid.swim

SLIME->damage.fallbig,damage.fallsmall,liquid.splash,liquid.swim,mob.slime.big,mob.slime.small,mob.slime.big,mob.slime.small

SNOWMAN->,damage.fallbig,damage.fallsmall,,liquid.splash,liquid.swim

SPIDER->mob.spider.death,damage.fallbig,damage.fallsmall,mob.spider.say,liquid.splash,liquid.swim

SQUID->,damage.fallbig,damage.fallsmall,,liquid.splash,liquid.swim

VILLAGER->mob.villager.death,damage.fallbig,damage.fallsmall,mob.villager.hit,liquid.splash,liquid.swim

WITCH->,damage.fallbig,damage.fallsmall,,liquid.splash,liquid.swim

WITHER->mob.wither.death,,,mob.wither.hurt,liquid.splash,liquid.swim

WOLF->mob.wolf.death,damage.fallbig,damage.fallsmall,mob.wolf.hurt,liquid.splash,liquid.swim

ZOMBIE->damage.fallbig,damage.fallsmall,liquid.splash,liquid.swim,mob.zombie.death,mob.zombie.death,mob.zombie.hurt,mob.zombie.hurt