_->game.player.die,game.player.hurt.fall.big,game.player.hurt.fall.small,game.player.hurt,game.player.swim.splash,game.player.swim

BAT->mob.bat.death,,,mob.bat.hurt,,

BLAZE->mob.blaze.death,game.hostile.hurt.fall.big,game.hostile.hurt.fall.small,mob.blaze.hit,game.hostile.swim.splash,game.hostile.swim

CAVE_SPIDER->mob.spider.death,game.hostile.hurt.fall.big,game.hostile.hurt.fall.small,mob.spider.say,game.hostile.swim.splash,game.hostile.swim

CHICKEN->mob.chicken.hurt,,,mob.chicken.hurt,game.neutral.swim.splash,game.neutral.swim

COW->mob.cow.hurt,game.neutral.hurt.fall.big,game.neutral.hurt.fall.small,mob.cow.hurt,game.neutral.swim.splash,game.neutral.swim

CREEPER->mob.creeper.death,game.hostile.hurt.fall.big,game.hostile.hurt.fall.small,mob.creeper.say,game.hostile.swim.splash,game.hostile.swim

ENDER_DRAGON->mob.enderdragon.end,,,mob.enderdragon.hit,,

ENDERMAN->mob.endermen.death,game.hostile.hurt.fall.big,game.hostile.hurt.fall.small,mob.endermen.hit,game.hostile.swim.splash,game.hostile.swim

ENDERMITE->mob.silverfish.kill,game.hostile.hurt.fall.big,game.hostile.hurt.fall.small,mob.silverfish.hit,game.hostile.swim.splash,game.hostile.swim

GHAST->mob.ghast.death,,,mob.ghast.scream,,

GIANT->game.hostile.die,game.hostile.hurt.fall.big,game.hostile.hurt.fall.small,game.hostile.hurt,game.hostile.swim.splash,game.hostile.swim

GUARDIAN->game.hostile.hurt.fall.big,game.hostile.hurt.fall.small,game.hostile.swim.splash,game.hostile.swim,mob.guardian.elder.death,mob.guardian.death,mob.guardian.elder.hit,mob.guardian.hit

HORSE->game.neutral.hurt.fall.big,game.neutral.hurt.fall.small,game.neutral.swim.splash,game.neutral.swim,mob.horse.death,mob.horse.donkey.death,mob.horse.zombie.death,mob.horse.skeleton.death,mob.horse.hit,mob.horse.donkey.hit,mob.horse.zombie.hit,mob.horse.skeleton.hit

IRON_GOLEM->mob.irongolem.death,game.neutral.hurt.fall.big,game.neutral.hurt.fall.small,mob.irongolem.hit,game.neutral.swim.splash,game.neutral.swim

MAGMA_CUBE->game.neutral.hurt.fall.big,game.neutral.hurt.fall.small,game.neutral.swim.splash,game.neutral.swim,mob.slime.big,mob.slime.small,mob.slime.big,mob.slime.small

MUSHROOM_COW->mob.cow.hurt,game.neutral.hurt.fall.big,game.neutral.hurt.fall.small,mob.cow.hurt,game.neutral.swim.splash,game.neutral.swim

OCELOT->mob.cat.hitt,game.neutral.hurt.fall.big,game.neutral.hurt.fall.small,mob.cat.hitt,game.neutral.swim.splash,game.neutral.swim

PIG->mob.pig.death,game.neutral.hurt.fall.big,game.neutral.hurt.fall.small,mob.pig.say,game.neutral.swim.splash,game.neutral.swim

PIG_ZOMBIE->mob.zombiepig.zpigdeath,game.hostile.hurt.fall.big,game.hostile.hurt.fall.small,mob.zombiepig.zpighurt,game.hostile.swim.splash,game.hostile.swim

RABBIT->mob.rabbit.death,game.neutral.hurt.fall.big,game.neutral.hurt.fall.small,mob.rabbit.hurt,game.neutral.swim.splash,game.neutral.swim

SHEEP->mob.sheep.say,game.neutral.hurt.fall.big,game.neutral.hurt.fall.small,mob.sheep.say,game.neutral.swim.splash,game.neutral.swim

SILVERFISH->mob.silverfish.kill,game.hostile.hurt.fall.big,game.hostile.hurt.fall.small,mob.silverfish.hit,game.hostile.swim.splash,game.hostile.swim

SKELETON->mob.skeleton.death,game.hostile.hurt.fall.big,game.hostile.hurt.fall.small,mob.skeleton.hurt,game.hostile.swim.splash,game.hostile.swim

SLIME->game.neutral.hurt.fall.big,game.neutral.hurt.fall.small,game.neutral.swim.splash,game.neutral.swim,mob.slime.big,mob.slime.small,mob.slime.big,mob.slime.small

SNOWMAN->,game.neutral.hurt.fall.big,game.neutral.hurt.fall.small,,game.neutral.swim.splash,game.neutral.swim

SPIDER->mob.spider.death,game.hostile.hurt.fall.big,game.hostile.hurt.fall.small,mob.spider.say,game.hostile.swim.splash,game.hostile.swim

SQUID->,game.neutral.hurt.fall.big,game.neutral.hurt.fall.small,,game.neutral.swim.splash,game.neutral.swim

VILLAGER->mob.villager.death,game.neutral.hurt.fall.big,game.neutral.hurt.fall.small,mob.villager.hit,game.neutral.swim.splash,game.neutral.swim

WITCH->,game.hostile.hurt.fall.big,game.hostile.hurt.fall.small,,game.hostile.swim.splash,game.hostile.swim

WITHER->mob.wither.death,,,mob.wither.hurt,game.hostile.swim.splash,game.hostile.swim

WOLF->mob.wolf.death,game.neutral.hurt.fall.big,game.neutral.hurt.fall.small,mob.wolf.hurt,game.neutral.swim.splash,game.neutral.swim

ZOMBIE->game.hostile.hurt.fall.big,game.hostile.hurt.fall.small,game.hostile.swim.splash,game.hostile.swim,mob.zombie.death,mob.zombie.death,mob.zombie.hurt,mob.zombie.hurt